NO textures/north_wall.xpm
SO textures/south_wall.xpm
WE textures/west_wall.xpm
EA textures/east_wall.xpm

F 17,180,227
C 190,222,98

11111111111
10000000101
10010000001
10000000001
10000E00001
10000000001
10000000001
10000000001
10000000001
10000000001
10000000001
11111111111